 @###   @@####  @#      @@####   @###   @@@@###       @###       @#      @@####  @#    @#  @@####  @#    
@@  ##  @@      @#      @@      @@  @#    @#         @@  ##      @#      @@      @#    @#  @@      @#    
@@#     @@      @#      @@      @@   #    @#         @@  ##      @#      @@      @#    @#  @@      @#    
 @@##   @@@@##  @#      @@@@##  @@        @#         @@  @#      @#      @@@@##  @#    @#  @@@@##  @#    
   @@#  @@      @#      @@      @@   #    @#         @@@@@#      @#      @@       @@  @@   @@      @#    
@@  @@  @@      @@      @@      @@  @#    @#         @@  @@      @@      @@        @@@@    @@      @@    
 @@@@   @@@@@@  @@@@##  @@@@@@   @@@@     @#         @@  @@      @@@@##  @@@@@@     @@     @@@@@@  @@@@##

