10 10
L.......T+
........TT
..........
..R.......
..R.....TT
........Tx
~~~~~~~~~~
~~~~~~~~~~
........RR
..........