6 10
TTTTTTTTTT
TL.......T
T.+R.TTT.T
T~..xT+T.T
TR..*TTT.T
TTTTTTTTTT