TTTTTTTTTT
TL.......T
T.+R.....T
T~..xT.T.T
T...*.TT.T
TTTTTTTTTT