6 10
TTTTTTTTTT
TL......xT
T.+R.TTTxT
T~..xT+T*T
TR..*TTT*T
TTTTTTT~~+